R 500 500
NO bluestone.xpm
SO bluestone.xpm
WE bluestone.xpm
EA bluestone.xpm
S bluestone.xpm
F 0,150,0
C 100,100,255

11111
1000111
10E0001
1000111
11111
