R 500 500
NO textures/wall1.xpm
SO textures/wall2.xpm
WE textures/wall3.xpm
EA textures/wall4.xpm
S textures/wall1.xpm
F 0,150,0
C 100,100,255

11111
1000111
10N0001
1000111
11111
