R 500 500
NO textures/wall1.xpm
SO textures/wall2.xpm
WE textures/wall3.xpm
EA textures/wall4.xpm
S textures/sprite2.xpm
F 0,150,0
C 100,0,255

1111111111111111111111111
1000000000110000000000001
1011000000020000000000001
10010200200000W0000000001
1111111110110000011100001
100000000011000001110111111111111
11111111111111111111111111111
