R 500 500
NO textures/wall1.xpm
SO textures/wall2.xpm
WE textures/wall3.xpm
EA textures/wall4.xpm
S textures/sprite.xpm
F 0,200,0
C 100,0,255

111111111111111111111
100000000000000000001
100020000000000020001
11111111000d000000001
111111111111000N00001
111111110000000000001
100200000000000000001
111111111111111111111
