R 700 500
NO textures/wall2.xpm
SO textures/wall2.xpm
WE textures/wall1.xpm
EA textures/wall2.xpm
S textures/sprite.xpm
F 0,200,0,
C 100,0,255

11111111
10200001
100N0001
10000001
11111111
