R 1213 800
NO textures/wall1.xpm
SO textures/wall2.xpm
WE textures/wall3.xpm
EA textures/wall4.xpm
S textures/sprite.xpm
F 245,194,66
C 34,22,112

       1111111111111111111111111
1111111100110011000000001
1011000001110000000000001
1001020000000000000000001
1111111110110000011100001
   100000000011000001110111111
11110111111111011100000010001
11110111111111011101010010001
11000000110101000001000010001
100000000000000000N200010001
10000000000020000001010010001
11001001110101011111011111111
11111111 1111111 11111111
